village,Nitrogen High,Nitrogen Medium,Nitrogen Low,Phosphorus High,Phosphorus Medium,Phosphorus Low,Potassium High,Potassium Medium,Potassium Low,Sulphur Sufficient,Sulphur Deficient,None High,None Medium,None Low,pH Alkaline,pH Acidic,pH Neutral,Iron Sufficient,Iron Deficient,Zinc Sufficient,Zinc Deficient,Copper Sufficient,Copper Deficient,Boron Sufficient,Boron Deficient,Manganese Sufficient,Manganese Deficient
Jahalda,0,21,23,16,21,7,25,19,0,12,32,31,13,0,0,27,17,44,0,33,11,44,0,1,43,44,0
Junia,0,2,6,2,2,4,6,2,0,0,8,7,0,1,0,3,5,8,0,3,5,8,0,0,8,8,0
Purulda,0,18,104,48,54,20,98,24,0,94,28,87,31,4,0,103,19,122,0,108,14,122,0,61,61,122,0
Nahalia,0,21,21,11,11,20,30,11,1,11,31,22,18,2,0,20,22,42,0,32,10,42,0,0,42,42,0
Bimbal Titia,0,7,8,10,3,2,10,5,0,3,12,10,4,1,0,10,5,15,0,11,4,15,0,0,15,15,0
Lalat,0,32,72,9,32,63,88,16,0,29,75,51,50,3,0,18,86,104,0,76,28,104,0,6,98,104,0
Karhia,0,5,8,0,11,2,10,3,0,5,8,8,3,2,0,6,7,13,0,9,4,13,0,0,13,13,0
Jalgoda,0,4,8,7,4,1,9,3,0,5,7,4,8,0,0,5,7,12,0,10,2,12,0,0,12,12,0
Amarda,0,34,30,15,26,23,53,11,0,16,48,35,27,2,0,19,45,64,0,51,13,64,0,1,63,64,0
Gamharipur,0,1,3,1,0,3,4,0,0,2,2,3,1,0,0,1,3,4,0,3,1,4,0,0,4,4,0
Renjura,0,3,4,1,2,4,6,1,0,2,5,3,3,1,0,3,4,7,0,7,0,7,0,0,7,7,0
Sabra,0,6,17,2,11,10,17,6,0,11,12,18,3,2,0,7,16,23,0,18,5,23,0,6,17,23,0
Baman Sai,0,3,0,0,0,3,3,0,0,2,1,0,2,1,0,1,2,3,0,3,0,3,0,0,3,3,0
Nahanjara,0,8,13,0,7,14,19,2,0,7,14,10,11,0,0,1,20,21,0,16,5,21,0,1,20,21,0
Mandalda,0,59,120,7,67,105,102,77,0,92,87,83,74,22,0,118,61,179,0,147,31,179,0,23,156,179,0
Palasi,0,1,7,1,5,2,3,5,0,6,2,7,1,0,0,6,2,8,0,7,1,8,0,5,3,8,0
Chauraigram,0,2,3,0,2,3,2,3,0,2,3,3,2,0,0,3,2,5,0,4,1,5,0,1,4,5,0
Kushumda,0,2,0,0,2,0,2,0,0,1,1,1,1,0,0,1,1,2,0,2,0,2,0,0,2,2,0
Kasnmali,0,21,24,0,22,23,16,29,0,13,32,21,20,4,0,27,18,45,0,37,8,44,1,2,43,45,0
Kiyari,0,2,3,0,3,2,3,2,0,2,3,2,3,0,0,5,0,5,0,3,2,5,0,2,3,5,0
Khandrui,0,0,3,0,3,0,1,2,0,1,2,2,1,0,0,3,0,3,0,3,0,3,0,1,2,3,0
Gopinathpur,0,1,2,1,2,0,2,1,0,2,1,2,1,0,0,3,0,3,0,3,0,3,0,2,1,3,0
Shyamsundarpur,0,0,2,0,2,0,0,2,0,1,1,2,0,0,0,1,1,2,0,2,0,2,0,0,2,2,0
Radhaballavpur,0,0,3,0,0,3,1,2,0,1,2,3,0,0,0,2,1,3,0,2,1,3,0,0,3,3,0
Santoshpur,0,8,10,1,9,8,16,2,0,9,9,10,6,2,0,13,5,18,0,15,3,18,0,2,16,18,0
Ekarukhi,0,2,17,5,13,1,10,9,0,17,2,17,2,0,0,15,4,19,0,17,2,19,0,12,7,19,0
Bamanda,0,6,3,0,4,5,7,2,0,3,6,6,2,1,0,4,5,9,0,9,0,9,0,0,9,9,0
Narayan Chak,0,1,3,0,0,4,3,1,0,1,3,2,2,0,0,1,3,4,0,4,0,4,0,0,4,4,0
Ramchandrapur,0,6,5,0,6,5,7,4,0,4,7,5,4,2,0,7,4,11,0,11,0,11,0,1,10,11,0
Nandakurya,0,0,7,4,3,0,1,6,0,6,1,7,0,0,0,6,1,7,0,6,1,7,0,3,4,7,0
Shyamsundarpur,0,0,4,1,2,1,0,4,0,1,3,2,2,0,0,2,2,4,0,3,1,4,0,1,3,4,0
Dhukurda,0,2,1,0,1,2,2,1,0,0,3,0,1,2,0,2,1,3,0,3,0,3,0,0,3,3,0
Turkakashba,0,1,1,0,2,0,0,2,0,2,0,2,0,0,0,2,0,2,0,2,0,2,0,1,1,2,0
Solemanpur,0,5,12,0,10,7,10,7,0,12,5,11,5,1,0,10,7,17,0,14,3,17,0,4,13,17,0
Bulakipur,0,2,2,0,2,2,3,1,0,0,4,0,2,2,0,2,2,4,0,3,1,4,0,0,4,4,0
Panch Kunia,0,1,7,2,5,1,3,5,0,7,1,8,0,0,0,7,1,8,0,7,1,8,0,3,5,8,0
Bastupur,0,1,5,0,5,1,1,5,0,5,1,6,0,0,0,2,4,6,0,6,0,6,0,3,3,6,0
Taldaratan Chak,0,3,8,0,6,5,4,7,0,6,5,5,5,1,0,7,4,11,0,8,3,11,0,2,9,11,0
Kurul,0,3,2,0,2,3,3,2,0,3,2,4,1,0,0,3,2,5,0,4,1,5,0,0,5,5,0
Jankapur,0,0,2,0,1,1,0,2,0,2,0,1,1,0,0,0,2,2,0,1,1,2,0,0,2,2,0
Keshrambha,0,3,3,0,2,4,5,1,0,4,2,2,1,3,0,5,1,6,0,5,1,6,0,2,4,6,0
Baicha,0,0,1,0,0,1,0,1,0,1,0,1,0,0,0,1,0,1,0,1,0,1,0,0,1,1,0
Purunda,0,0,17,8,9,0,14,3,0,17,0,17,0,0,0,16,1,17,0,14,3,17,0,15,2,17,0
Lalpur,0,0,5,1,4,0,2,3,0,5,0,5,0,0,0,4,1,5,0,4,1,5,0,3,2,5,0
Patpur,0,0,11,1,10,0,8,3,0,11,0,9,1,1,0,10,1,11,0,9,2,11,0,4,7,11,0
Dhaneswarpur,0,0,1,0,1,0,0,1,0,1,0,1,0,0,0,0,1,1,0,1,0,1,0,1,0,1,0
Bardaltitia,0,0,3,0,3,0,2,1,0,3,0,3,0,0,0,1,2,3,0,3,0,3,0,2,1,3,0
Kalyanpur,0,0,2,0,2,0,0,2,0,2,0,2,0,0,0,2,0,2,0,1,1,2,0,2,0,2,0
Sohag Pur,0,0,2,0,2,0,1,1,0,2,0,2,0,0,0,2,0,2,0,2,0,2,0,1,1,2,0
Kedar,0,0,11,4,6,1,5,6,0,11,0,11,0,0,0,10,1,11,0,9,2,11,0,8,3,11,0
Haripur,0,0,5,1,4,0,2,3,0,5,0,5,0,0,0,4,1,5,0,5,0,5,0,2,3,5,0
Banshi Chak,0,0,1,0,1,0,1,0,0,1,0,1,0,0,0,1,0,1,0,1,0,1,0,0,1,1,0
Gopalpur,0,0,1,0,1,0,0,1,0,1,0,1,0,0,0,1,0,1,0,1,0,1,0,0,1,1,0
Krishnapur,0,0,3,1,2,0,1,2,0,3,0,3,0,0,0,3,0,3,0,3,0,3,0,2,1,3,0
Sauri Urf.Kotbar,0,0,4,0,4,0,3,1,0,4,0,4,0,0,0,4,0,4,0,4,0,4,0,1,3,4,0
Agarbar,0,0,4,1,3,0,2,2,0,4,0,4,0,0,0,4,0,4,0,4,0,4,0,3,1,4,0
Digha,0,0,1,1,0,0,1,0,0,1,0,1,0,0,0,1,0,1,0,1,0,1,0,0,1,1,0
Brahman Khalisa,0,0,1,0,1,0,1,0,0,1,0,1,0,0,0,1,0,1,0,1,0,1,0,1,0,1,0
Bandh Rauta,0,0,1,0,1,0,0,1,0,1,0,1,0,0,0,1,0,1,0,1,0,1,0,0,1,1,0
Narasinghapur,0,0,1,0,1,0,0,1,0,1,0,1,0,0,0,1,0,1,0,1,0,1,0,1,0,1,0
Lakibar,0,0,2,1,1,0,2,0,0,2,0,2,0,0,0,2,0,2,0,2,0,2,0,2,0,2,0
Damodarpur,0,0,1,0,1,0,1,0,0,1,0,1,0,0,0,1,0,1,0,1,0,1,0,1,0,1,0
Mulada,0,0,1,1,0,0,0,1,0,1,0,1,0,0,0,1,0,1,0,0,1,1,0,0,1,1,0
Agabar Chak,0,0,1,0,1,0,1,0,0,1,0,1,0,0,0,1,0,1,0,1,0,1,0,0,1,1,0
Biharichak,0,0,2,1,1,0,2,0,0,2,0,2,0,0,0,2,0,2,0,2,0,2,0,0,2,2,0
Sadi Chak,0,0,1,0,1,0,0,1,0,1,0,1,0,0,0,0,1,1,0,1,0,1,0,1,0,1,0
